0
6
60
15
0,1,1,1,1,1
1,0,3,2,1,1
2,2,3,2,2,1
1,2,3,2,1,1
1,1,1,1,0,1
1,1,1,1,1,0
2
2,3,1
3,4,2